1111111111111111111111111111111111
1000000C0000000000C00000000000C001
1000100111101111010111100010100001
1001000100001001000100000100010001
101C00011110111101011100100C001001
1001000000101001010100010C00010001
10001001111010010101001000C0000001
100C0000P000000C0000000C00000000E1
1111111111111111111111111111111111