1111111111111111111111111111111111
1P00N000000CN000C000000C0000N00001
1000100111101111010111100010100001
1001000100001001000100000100010001
1010CC0111101111010111001000001001
100100000010100101010C010000010001
1000100111101001010100100000100001
100C000N000C00000N00000N0CC00000E1
1111111111111111111111111111111111